
11111111
10000001
111CCC11
110EEEP1
11111111

