
1111111111111111111111111111
100000010000000C000111111111
111C00E1EEE11000000000000001
11010P00000000000CC000000001
11111000000CC11111CC11100001
11010C00000000000CCCE0000CC1
100000010000000C000111111111
111C00E1EEE11000111100000001
11010000000000000CC100000001
11111000000CC111111111100001
11010C00000000000CC00C000CC1
11010C000000E0000CC1010001C1
11010C00000000000CC110000CC1
100000010000000C000111111111
111C00E1EEE11000111100000001
11010E00000000000CC100000001
11111000000CC111111111100001
11010C00000000000CC00C000CC1
11010C000000E0000CC1010001C1
11010C00000000000CC110000CC1
1111111111111111111111111111
