111111111111111111111111111
100000010000000C000000C0011
111C00E1EEE110001111000C001
11010P00000000000CC1000C001
11010P000001000E0CC000C0011
11010P00100000000C000C00111
11010P000001000E0CC000C0011
11010P00100000000CC11100001
11010P000001000E0CC11000C01
11010P00100000000CC11000111
111111111111111111111111111