1111111111
1PEC100001
1111111111
1CEC110001
1111111111
1CEC1CCEE1
1111100001
1CEC000001
1111111111